1111111111111
100000E000001
100C000000101
1000000P00001
1111111111111