1111111111
1C00000001
1010101001
1010101001
100E001001
1C000C1P01
1111111111